0xA66A35
0xF8A860
0xE9967A
0xA8682F
0xA66A35
6112342245555000011111111111111111111111111
0000012030000000040400000090000000000000000
0000000000000001005000000000000000000000000
0000000000000000000000000000000000000000000
0000000000000000000000000000000000000000000
0000020050001210060600000000000000000000000