0x8B4513
0x008000
0x87CEFA
0xFFFFFF
0x8B4513
311011000022323400003300000000000000000000
000001203000000004040000000000009000000000
000000000000000100500000000000000000000000
000000000000000000000039000000000000000000
000000000000000000000000000000000000000000
000002005000121006060000000000000000000000