0x8B4513
0x008000
0x87CEFA
0xFFFFFF
0x8B4513
3110110000223234000033111111
0900012030000000040400000090
0000000000000001005000000000
0000100000000000000000000000
0000000000000000000000000000
0000020050001210060600000000