9110110000223234000033111111111111111111111
0000012030000000040400000090000000000000000
0000000000000001005000000000000000000000000
0000000000000000000000000000000000000000000
0000020050001210060600000000000000000000000